VVcbVVVVVVVVVcVVVbVVVVV
VbcbbVVVcVVVVcbccbccVVV
TTTTTTTTTTTTTTTTTTTTTTT
DDDDDBB............DDDD
DDDDD...........o.DDDDD
DDDDD.....B..DDDDDDDDDD
DDDDD..D....BDBBBBDDDDD
eeDDDD.DB....B....BDDeD
DDDDBB.B...D.......DeeD
DDBB.......DD...B..DDDD
DD.........BBB.....DDDD
DD.d..............DDDDD
DDDDDDDDDDDDDD....DDDDD
DDDDDDDDDDDDDDD..aDDDgg
DaDDDDDDDeeDDDDDDDDDDDg