VVcVVVbbVVVbVVVVVbVVVVV
VbbVVcccbVVccVVVbcccVVV
TTTTTTTTTTTTTTTTTTTTTTT
DD....D.............DDD
DD.dD................DD
aDBDBBB.....o...DDB..DD
DD.B.......BBB..DD..BDa
DD..............BD...DD
DD.........DD....BB..eD
DD...DDD...DDD......DDD
DDD..BBB...BDDDD..B.DDD
DDD.........DDDD....DDe
gDDD........DeeDD...gDD
gDDDDDDDDDDDDDeDDDDDgDD
ggDDDaaDaDDDDDDDDDaDDDD
