"VVcbVVVVVVVVVVVVcVVVbVV",
"VbcbbVVVVcVVVVVcbcVVccb",
"TTTTTTTTTTTTTTTTTTTTTTT",
"DDDDDDDDDDDDDDDDDDDDDDD",
"DDDBBBBDDDDDDDDDBBBBDDD",
"DDB....BBDDDDDBB....BDD",
"DD.......BBBBB.......DD",
"DD...................DD",
"DD...................DD",
"DDD.................DDD",
"DDDDDD...........DDDDDD",
"DDDDDDDD.......DDDDDDDD",
"DDDDDDDDDDDDDDDDDDDDDDD",
"DDDDDDDDDDDDDDDDDDDDDDD",
"DDDDDDDDDDDDDDDDDDDDDDD",