"VVcbVVVVVVVVVVVVcVVVbVV",
"VbcbbVVVVcVVVVVcbcVVccb",
"TTTTTTTTTTTTTTTTTTTTTTT",
"DDDDBBB...........DDDDD",
"DDDD..............DDDDD",
"DDDD........DBBDDDDDDDD",
"DDD....D...BB..BDDDDDDD",
"DDDDDDDDD.......BDDDDDD",
"DDDBBBBBBB.......DDDDDD",
"DDD.........DDDDDDDDDDD",
"DDD.........DDDDDDDDDDD",
"DDD......DDDDDDDDDDDDDD",
"DDDDDD.DDDDDDDDDDDDDDDD",
"DDDDDD.DDDDDDDDDDDDDDDD",
"DDDDDDDDDDDDDDDDDDDDDDD",