"VVcbVVVVVVVVVVVVcVVVbVV",
"VbcbbVVVVcVVVVVcbcVVccb",
"TTTTTTTTTTTTTTTTTTTTTTT",
".......................",
".......................",
".......................",
".......................",
".......................",
".......................",
".......................",
".......................",
".......................",
".......................",
".......................",
"DDDDDDDDDDDDDDDDDDDDDDD",